1111111111
1C0P011111
11C0011111
11E0011111
1C0C011101
1111111111